00000000000000000000
01111111111111111110
01010100001010000010
01010001001010010010
01011101111010011110
01000100000010000000
01100111110010001110
01000000010010101010
01011111110010111010
00000000000010000010
01111111111111111110
00000000000000000000